PROFESOR
javisgarr 	realmadrid2020	Javier Sanz Garrido
kathethom 	eixoov0AGh	Katherine Thompson
GPotter 	ohTohPiech6ei	Georgia Potter
Belserra 	Eejieh7ooBee	Beltran Serrano Tafoya
naiara44 	Ohg5ohngao	Naiara Cervántez Muñoz
GarcilasoOG 	wiZohg5j	Garcilaso Oquendo García
JCarlosBH 	umeephieH1ie	Juan Carlos Barreto Hernández
margaVT 	Eecoh7ahnae	Margarita Vega Téllez
martaProsa 	OoChi4chue	Marta Pedroza Rosario
adenapine 	aViehoh5ees	Adena Pineda Montero
casianotrejo 	Qua2tieng8	Casiano Trejo Lozano
brunaguime 	Dopha8hei	Bruna Guillén Merino
hannahThomp 	Ohfee3jei8Oo	Hannah Thompson
Jcrespo		Ed7Aipu8fei	Jose Crespo Aponte
Jvercorrea 	gaiV8yahNg	Jose Verdugo Correa
Balvercast 	ieThie0oomee	Balbino Verdugo Castro
cleocarcu 	Gohc5yo5	Cleodora Carvajal Curiel
julivargas 	Be4aiGhael5	Juliano Vargas Rosas
liobamuñoz 	Au3daeNga	Lioba Solórzano Muñoz
Ethelsana 	vah6maiGh5	Ethel Llarnas Sanabria

TUTOR legal			(hijos/alumnos)
Fcriscas	haeh2xohnooB	Oscar Cristobal Fernández
				Tara Cristobal Fernández
bautistaIC	au2Uevaicei	Alanis Ibarra Padrón
elerochaval	Fee0tohv	Solano Rocha Cedillo
mmnaranj	eeWah7sie	Rayen Sánchez Marín
helezuna	sho6Eep9wei	Zohar Núñez Ozuna
gararemon	aiKoh0ipuw	Munir Árias Regalado
lujamaya	uiqu9uF0ie	Xaviera Amaya Hernández
pedrotero	ji6Cui6oo	Horaz Otero Espinosa
cleyva		AhhuaMai3ie	Laviana Leyva Guerrero
emibugalin	OoTha3ae	Neus Benavides Bustos
ernesporras	Aung7iM0ah	Olalla Porras Rolón
anavillaper	xahv4Nani6Oo	Romanela Alarcón Villaseñor

ADMINISTRADOR
admin		administrador
